##############################
*****************************#
*****************************#
*****************************#
*****************************#
*****************************#
*****************************#
*****************************#
*****************************#
*****************************#
*****************************#
*****************************#
*****************************#
*****************************#
*****************************#
*****************************#
*****************************#
*****************************#
*****************************#
******************************