******************############
########**********************
******************************
**************#############***
******************************
******************************
#########*********************
******************************
******************##########**
******************************
******************************
*********###############******
******************************
******************************
***********************#######
******************************
*****################*********
******************************
******************************
********######################