********#######**********
*************************
*************************
*************************
*************************
*************************
************************#
************************#
************************#
************************#
*****####################
*************************
*************************
*************************
*************************
#************************
#************************
#************************
#******************###***
#************************
*************************
*************************
*************************
*************************
*************************